~~~~~~_________?...._______E_F
__~~~~~__E_____________....~~_
____~~~~~~~_________..__E~~___
_______~~~~~~~~________~~_____
__________~~~~__E____[[..___..
___________[[[[E__~~~~_____...
____________~~~~~~~~_______?..
_________E____~~~~____E______
__E____________~~~____________
H______________~~~~~_________T